10 10
wwwwwwwwww
w   P    w
w        w
w     S  w
wdwwwwwdww
w        w
w        w
w  S     w
w        w
wwwwwwwwww